##########################
#                        #
#                        #
#    ##      ##          #
#                        #
#                        #
#       ####             #
#                        #
#                        #
#    ##      ##          #
#                        #
#                        #
##########################
