########################################
#                                      #
#  ##    ##          ##    ##          #
#                                      #
#    ####                      ####    #
#                                      #
#  ##    ##          ##    ##          #
#                                      #
#    ####                      ####    #
#                                      #
#  ##    ##          ##    ##          #
#                                      #
#    ####                      ####    #
#                                      #
#  ##    ##          ##    ##          #
#                                      #
#    ####                      ####    #
#                                      #
#  ##    ##          ##    ##          #
#                                      #
########################################
